-01 -01 -01 -01 -01 -01 -01 -01 -01 -01 -01 -01 -01 -01 -01 -01
-01 000 001 -03 002 003 004 005 006 007 008 009 010 011 012 -01
-01 013 -08 -05 -02 -02 -02 -02 014 -02 -04 -02 -02 -09 015 -01
-01 016 -03 017 018 019 020 021 022 023 -03 024 025 -03 026 -01
-01 027 -03 028 -02 -02 -02 -02 -02 -02 -05 -09 029 -11 -02 -01
-01 030 -03 031 032 033 034 035 036 037 038 -03 039 040 041 -01
-01 042 043 044 045 046 -08 047 048 -09 049 050 051 052 053 -01
-01 054 055 056 -03 057 058 -20 -20 059 060 061 062 -03 063 -01
-01 064 -08 -02 -07 065 066 -20 -20 067 068 -03 069 -03 070 -01
-01 071 -03 072 -03 073 -11 074 075 -10 076 -03 077 -03 078 -01
-01 079 -03 080 -03 081 082 083 084 085 086 -03 087 -03 088 -01
-01 -02 -07 089 -11 -02 -02 -02 -02 -02 -02 -10 090 -03 091 -01
-01 092 -03 093 094 095 096 097 098 099 100 101 102 -03 103 -01
-01 104 -11 -02 -02 -02 -02 -02 -02 105 106 -02 -02 -10 107 -01
-01 108 109 110 111 112 113 114 115 116 117 118 119 120 121 -01
-01 -01 -01 -01 -01 -01 -01 -01 -01 -01 -01 -01 -01 -01 -01 -01